R 1000 700
NO ./textures/purplestone.xpm
SO ./textures/SO.xpm
WE ./textures/WE.xpm
EA ./textures/EA.xpm

S ./textures/S.xpm
F 172, 182, 142
C 175, 218, 252

11111111111111111111111111
1   1100000011100000020001
1  10002010011100011111111
1110100101111  1001
1010100000101  1021
1111111001111  1001111111
1000011001111  1000001111
100S001001111111000000111
10000000200000200000200001
10002000000000000000000001
11111111111111111111111111
